1111111111111
100100CC000C1
10C0011111001
1P00111E00001
1111111111111